************************************************************************************
*                                                                                  *
****  *************   ********************       ********    **************        *
*                                        *       *                        *        *
*        ********   **********************       *      *                 *        *
*        *                                       *      *                 *        *
*        *             **************    *********      *    *********    *        *
*        *                                              *        *        *        *
*                      *                                *        *        *        *
*        ***************    *****************************        *        *        *
*        *                                                       *                 *
*                                       ************    *        *        *        *
*        ********************           *               *        *        *        *
*        *                  *                           *        *        *        *
*        *                  *************               *    *********    *        *
*                                                                                  *
************************************************************************************
